.....o...................o.....
.....ooo...............ooo.....
........o.............o........
.......oo.............oo.......
...............................
oo...........................oo
.o...........oo..............o.
.o.o.........oo............o.o.
..oo.......................oo..
...................o.o.........
..................o..o.........
..................o..o.........
...........o.......o...........
.........o..o..................
.........o..o..................
.........o.o...................
..oo.......................oo..
.o.o............oo.........o.o.
.o..............oo...........o.
oo...........................oo
...............................
.......oo.............oo.......
........o.............o........
.....ooo...............ooo.....
.....o...................o.....
