.....o.o.....
......o......
...oo.o.oo...
..o...o...o..
..o.......o..
o...........o
.ooo.....ooo.
o...........o
..o.......o..
.o.........o.
...o.....o...
ooo.......ooo
...o.....o...
.o.........o.
..o.......o..
o...........o
.ooo.....ooo.
o...........o
..o.......o..
..o...o...o..
...oo.o.oo...
......o......
.....o.o.....
