.......o......
......o.o.....
.......o......
..............
.....ooooo....
....o.....o.oo
...o.oo...o.oo
...o.o..o.o...
oo.o...oo.o...
oo.o.....o....
....ooooo.....
..............
......o.......
.....o.o......
......o.......
